..........
.....a....
...a......
.oo.......
......a...
..........
..........