............
........O...
.....O......
.......O....
....O.......
......A.....
............
............
........A...
.........A..
............
.........O..